000000000I000000000
0111010011100101110
0101110111110111010
0100000101010000010
011111111O111111110
0100000101010000010
0101110111110111010
0111010011100101110
0000000000000000000