0I00000000000000000000000000000000000000000000000000000000000
0101000111111101000100010101110100010001000001110111110001000
0111000101010100000101010000010001000101010001011100010000000
0101000100000101110000000001000000000111010000010001011111110
0111011100010101000100000001000001000101010111000100010001010
0001010001011100010001000100000100000100010100010000010000010
0001110100000100010100000111000101000001000001010001110001010
0000010001000111000000010100000100000000000001010100010111010
0101000001010001111111111111111111111111111111111111110001110
00000000000000000000000000000000000000000000000000000000000O0