000000000000000I000
0111111111111111110
0100000000000000000
0111111111111101110
0100010000010101010
0111010111010101010
0101010001010101010
0101011111010111010
00000000000O0000000
