XIXXXXXXXXXXXXXXXXXXXXXXXXXXXXXXXXXXXXXXXXXXXXXXXXXXXXXXXXXXX
X X XXX       X XXX XXX X X   X XXX XXX XXXXX   X     XXX XXX
X   XXX X X X XXXXX X X XXXXX XXX XXX X X XXX X   XXX XXXXXXX
X X XXX XXXXX X   XXXXXXXXX XXXXXXXXX   X XXXXX XXX X       X
X   X   XXX X X XXX XXXXXXX XXXXX XXX X X X   XXX XXX XXX X X
XXX X XXX X   XXX XXX XXX XXXXX XXXXX XXX X XXX XXXXX XXXXX X
XXX   X XXXXX XXX X XXXXX   XXX X XXXXX XXXXX X XXX   XXX X X
XXXXX XXX XXX   XXXXXXX X XXXXX XXXXXXXXXXXXX X X XXX X   X X
X X XXXXX X XXX                                       XXX   X
XXXXXXXXXXXXXXXXXXXXXXXXXXXXXXXXXXXXXXXXXXXXXXXXXXXXXXXXXXXOX