00000000000000000000
01011111111011111110
01010000100010000000
01010111111111111110
01010100000100010100
01000101110101010100
I1111101110101000000
01000001010111111110
0101111101110111001O
00000000000000000000
