0I0000000000000000000000000000000000000000000000000000000000000
011111011111110111011111110111110111111111110111111111111101110
000001000100010100010100010100010000000100010000000001000101010
011101110111010111110101010101010111111101110111111111011101010
010000010001010000000101010101010100000001000101000000010001010
011111011111011111111101011101110111110111011101011111011101010
010001000000000000000001000001000100010001010100010001000100010
011101111111110111110111011111011111011101010101111101110111010
000000000001010100010001010000000000000101000101000000010001010
011111111111011101111111010111111111111101110111110111110111110
010000000100000001000000010100000000000000010000000100000000000
010111110101110111110111010111111111110111011111110101111111110
010001010101010000000101010100000000010101000000010101000000010
011101011101011111110101110101111111110101111111010101110111010
000101000001000000010100000001000000000100010000010100010100010
011101110101011111110111011111011101111101011111111111010111010
010000010101010000000001010000010001000001000000000001010101010
010111111101011101110111010111111101011111110111011111010101010
010000000001000101010100010000000101000000010101000000010001010
011111111111110111010111011111110101111101110101111111111111010
000000000000000000010001000000010100000101000100000000000000010
0111111111111111011101110111111101111111110111011111011101111101
0100000000000001010101000100000001000000000100010001000101000101
0101110111111101110101010111110101010111110111110111011101110101
0101010000010000000101010100010101010100010000000100010000010001
0111010111011111110101011111010111110101011111011101111111011101
0000010101000100010101000000010000000101010001010000000001000101
0111110101110111011101111111011111110101010111011101111111110101
0100000100010001000000000001000000010101010000000101000000010101
0111111111010111111111110111011111110101011111011101011111110101
0000000000010000000000010100010000000101000001010001000000000101
0111111111011111011111010101111111011101111101011111011111111101
0100000001000001010001000100000001010000010101000001010000000001
0101111101111101110101110111111101011111110101111111011111111101
0101000100000101000100010000000101000000000100000000000000000101
0111110111110101110111010111110101111111011101011111011111111101
0000000000010100010001010101000101010000010001010001010000000101
0111111111110101111111011101011101011111110111010101011111011101
0100000000000100000000000001010001000000000001010101010001010001
0111111101110111111111111101010101110111111111010111011101010101
0000000100010000000000000101010100010100000001010001000001010101
0111111101111111110111110101010111011101111101011101111111011101
0100000001000000010100000101010001000000010101000100000000000001
0111011111111101011101111111010111111111110101110111111111111101
0101010000000101010001000000010100000000000101000000000000000101
0101010111110101110111010111110111011101111101011111111111111101
0101000100010100000100010100000101010100000001010000000000000101
0101110111010111011111110111011101110111111111010111111111011101
0000010001010001010000000001000000010000000000010000010000010001
0111110111011101110111111101111111011111110111011111011111110101
0100000100000100000100000100000001000000000101000001000000010101
0111111111110111110101110111011101111111111101110111011111011101
0100000000010000010100010100010100000000000000010100010001000101
0101111101111111010111110111110111110111111111010111111101110101
0001000100000000010000010000000001010000000100010100000000010101
0111011111011101110111010111111101011111111101110101111111110101
0100000001010101010001010000000101000000000101000001000000000101
0111111101110111010111011111111101110101110101011111011111110101
0100000100000000010100000000000100010101010101010000010000010101
0101111101111111111101111111110101010111011101011101110111110101
0101000000000000000001000100000101010000000001000101000000000101
0101111111111111111111110111111111011111111111111101111111111101
0000000000000000000000000000000000000000000000000000000000000O01